's Herenelderen	Tongeren
's-Gravenvoeren	Voeren
's-Gravenwezel	Schilde
Aaigem	Erpe-Mere
Aalbeke	Kortrijk
Aalst	Aalst
Aalst	Sint-Truiden
Aalter	Aalter
Aarschot	Aarschot
Aarsele	Tielt
Aartrijke	Zedelgem
Aartselaar	Aartselaar
Achel	Hamont-Achel
Adegem	Maldegem
Adinkerke	De Panne
Afsnee	Gent
Alken	Alken
Alsemberg	Beersel
Alveringem	Alveringem
Antwerpen	Antwerpen
Anzegem	Anzegem
Appels	Dendermonde
Appelterre-Eichem	Ninove
Ardooie	Ardooie
Arendonk	Arendonk
As	As
Aspelare	Ninove
Asper	Gavere
Asse	Asse
Assebroek	Brugge
Assenede	Assenede
Assent	Bekkevoort
Astene	Deinze
Attenhoven	Landen
Attenrode-Wever	Glabbeek
Avekapelle	Veurne
Avelgem	Avelgem
Averbode	Scherpenheuvel-Zichem
Baaigem	Gavere
Baal	Tremelo
Baardegem	Aalst
Baarle-Hertog	Baarle-Hertog
Baasrode	Dendermonde
Bachte-Maria-Leerne	Deinze
Balegem	Oosterzele
Balen	Balen
Bambrugge	Erpe-Mere
Bassevelde	Assenede
Batsheers	Heers
Bavegem	Sint-Lievens-Houtem
Bavikhove	Harelbeke
Bazel	Kruibeke
Beek	Bree
Beerlegem	Zwalm
Beernem	Beernem
Beerse	Beerse
Beersel	Beersel
Beerst	Diksmuide
Beert	Pepingen
Beervelde	Lochristi
Beerzel	Putte
Begijnendijk	Begijnendijk
Beigem	Grimbergen
Bekegem	Ichtegem
Bekkerzeel	Asse
Bekkevoort	Bekkevoort
Bellegem	Kortrijk
Bellem	Aalter
Bellingen	Pepingen
Belsele	Sint-Niklaas
Berbroek	Herk-de-Stad
Berchem	Antwerpen
Berchem	Kluisbergen
Berendrecht-Zandvliet-Lillo	Antwerpen
Berg	Kampenhout
Berg	Tongeren
Beringen	Beringen
Berlaar	Berlaar
Berlare	Berlare
Berlingen	Wellen
Bertem	Bertem
Beselare	Zonnebeke
Betekom	Begijnendijk
Bevel	Nijlen
Bever	Bever
Bevere	Oudenaarde
Beveren	Alveringem
Beveren	Beveren
Beveren	Roeselare
Beveren	Waregem
Beverlo	Beringen
Beverst	Bilzen
Bierbeek	Bierbeek
Bikschote	Langemark-Poelkapelle
Bilzen	Bilzen
Binderveld	Nieuwerkerken
Binkom	Lubbeek
Bissegem	Kortrijk
Blaasveld	Willebroek
Blanden	Oud-Heverlee
Blankenberge	Blankenberge
Bocholt	Bocholt
Boechout	Boechout
Boekhout	Gingelom
Boekhoute	Assenede
Boezinge	Ieper
Bogaarden	Pepingen
Bommershoven	Borgloon
Bonheiden	Bonheiden
Booischot	Heist-op-den-Berg
Booitshoeke	Veurne
Boom	Boom
Boorsem	Maasmechelen
Boortmeerbeek	Boortmeerbeek
Borchtlombeek	Roosdaal
Borgerhout	Antwerpen
Borgloon	Borgloon
Borlo	Gingelom
Bornem	Bornem
Borsbeek	Borsbeek
Borsbeke	Herzele
Bossuit	Avelgem
Bost	Tienen
Bottelare	Merelbeke
Boutersem	Boutersem
Bouwel	Grobbendonk
Bovekerke	Koekelare
Brasschaat	Brasschaat
Brecht	Brecht
Bredene	Bredene
Bree	Bree
Breendonk	Puurs
Brielen	Ieper
Broechem	Ranst
Broekom	Borgloon
Brugge	Brugge
Brussegem	Merchtem
Brustem	Sint-Truiden
Budingen	Zoutleeuw
Buggenhout	Buggenhout
Buizingen	Halle
Buken	Kampenhout
Bulskamp	Veurne
Bunsbeek	Glabbeek
Burcht	Zwijndrecht
Burst	Erpe-Mere
Buvingen	Gingelom
Dadizele	Moorslede
Daknam	Lokeren
Damme	Damme
De Klinge	Sint-Gillis-Waas
De Moeren	Veurne
De Panne	De Panne
De Pinte	De Pinte
Deerlijk	Deerlijk
Deftinge	Lierde
Deinze	Deinze
Denderbelle	Lebbeke
Denderhoutem	Haaltert
Denderleeuw	Denderleeuw
Dendermonde	Dendermonde
Denderwindeke	Ninove
Dentergem	Dentergem
Dessel	Dessel
Desselgem	Waregem
Destelbergen	Destelbergen
Desteldonk	Gent
Deurle	Sint-Martens-Latem
Deurne	Antwerpen
Deurne	Diest
Diegem	Machelen
Diepenbeek	Diepenbeek
Diest	Diest
Diets-Heur	Tongeren
Dikkebus	Ieper
Dikkele	Zwalm
Dikkelvenne	Gavere
Diksmuide	Diksmuide
Dilbeek	Dilbeek
Dilsen	Dilsen-Stokkem
Doel	Beveren
Donk	Herk-de-Stad
Dormaal	Zoutleeuw
Dranouter	Heuvelland
Drieslinter	Linter
Drogenbos	Drogenbos
Drongen	Gent
Dudzele	Brugge
Duffel	Duffel
Duisburg	Tervuren
Duras	Sint-Truiden
Dworp	Beersel
Edegem	Edegem
Edelare	Oudenaarde
Eeklo	Eeklo
Eernegem	Ichtegem
Egem	Pittem
Eggewaartskapelle	Veurne
Eigenbilzen	Bilzen
Eindhout	Laakdal
Eine	Oudenaarde
Eisden	Maasmechelen
Eke	Nazareth
Ekeren	Antwerpen
Eksaarde	Lokeren
Eksel	Hechtel-Eksel
Elen	Dilsen-Stokkem
Elene	Zottegem
Elewijt	Zemst
Eliksem	Landen
Elingen	Pepingen
Ellikom	Meeuwen-Gruitrode
Elsegem	Wortegem-Petegem
Elst	Brakel
Elverdinge	Ieper
Elversele	Temse
Emblem	Ranst
Emelgem	Izegem
Ename	Oudenaarde
Engelmanshoven	Sint-Truiden
Eppegem	Zemst
Erembodegem	Aalst
Erondegem	Erpe-Mere
Erpe	Erpe-Mere
Erps-Kwerps	Kortenberg
Ertvelde	Evergem
Erwetegem	Zottegem
Esen	Diksmuide
Essen	Essen
Essene	Affligem
Etikhove	Maarkedal
Ettelgem	Oudenburg
Everbeek	Brakel
Everberg	Kortenberg
Evergem	Evergem
Ezemaal	Landen
Gaasbeek	Lennik
Galmaarden	Galmaarden
Gavere	Gavere
Geel	Geel
Geetbets	Geetbets
Gelinden	Sint-Truiden
Gellik	Lanaken
Gelrode	Aarschot
Geluveld	Zonnebeke
Geluwe	Wervik
Genk	Genk
Genoelselderen	Riemst
Gent	Gent
Gentbrugge	Gent
Geraardsbergen	Geraardsbergen
Gerdingen	Bree
Gestel	Berlaar
Gierle	Lille
Gijverinkhove	Alveringem
Gijzegem	Aalst
Gijzelbrechtegem	Anzegem
Gijzenzele	Oosterzele
Gingelom	Gingelom
Gistel	Gistel
Gits	Hooglede
Glabbeek-Zuurbemde	Glabbeek
Godveerdegem	Zottegem
Goeferdinge	Geraardsbergen
Goetsenhoven	Tienen
Gontrode	Melle
Gooik	Gooik
Gooreind	Wuustwezel
Gors-Opleeuw	Borgloon
Gorsem	Sint-Truiden
Gotem	Borgloon
Gottem	Deinze
Grammene	Deinze
Grazen	Geetbets
Grembergen	Dendermonde
Grimbergen	Grimbergen
Grimminge	Geraardsbergen
Grobbendonk	Grobbendonk
Groot-Bijgaarden	Dilbeek
Groot-Gelmen	Sint-Truiden
Groot-Loon	Borgloon
Grote-Brogel	Peer
Grote-Spouwen	Bilzen
Grotenberge	Zottegem
Gruitrode	Meeuwen-Gruitrode
Guigoven	Kortessem
Gullegem	Wevelgem
Gutschoven	Heers
Haacht	Haacht
Haaltert	Haaltert
Haasdonk	Beveren
Haasrode	Oud-Heverlee
Hakendover	Tienen
Halen	Halen
Hallaar	Heist-op-den-Berg
Halle	Halle
Halle	Zoersel
Halle-Booienhoven	Zoutleeuw
Halmaal	Sint-Truiden
Hamme	Hamme
Hamme	Merchtem
Hamont	Hamont-Achel
Handzame	Kortemark
Hansbeke	Nevele
Harelbeke	Harelbeke
Hasselt	Hasselt
Hechtel	Hechtel-Eksel
Heers	Heers
Hees	Bilzen
Heestert	Zwevegem
Heffen	Mechelen
Heikruis	Pepingen
Heindonk	Willebroek
Heist	Knokke-Heist
Heist-op-den-Berg	Heist-op-den-Berg
Hekelgem	Affligem
Heks	Heers
Helchteren	Houthalen-Helchteren
Heldergem	Haaltert
Helen-Bos	Zoutleeuw
Helkijn	Spiere-Helkijn
Hemelveerdegem	Lierde
Hemiksem	Hemiksem
Hendrieken	Borgloon
Henis	Tongeren
Heppen	Leopoldsburg
Herderen	Riemst
Herdersem	Aalst
Herent	Herent
Herentals	Herentals
Herenthout	Herenthout
Herfelingen	Herne
Herk-de-Stad	Herk-de-Stad
Herne	Herne
Herselt	Herselt
Herstappe	Herstappe
Herten	Wellen
Hertsberge	Oostkamp
Herzele	Herzele
Heule	Kortrijk
Heurne	Oudenaarde
Heusden	Destelbergen
Heusden	Heusden-Zolder
Hever	Boortmeerbeek
Heverlee	Leuven
Hillegem	Herzele
Hingene	Bornem
Hoboken	Antwerpen
Hoegaarden	Hoegaarden
Hoeilaart	Hoeilaart
Hoeke	Damme
Hoelbeek	Bilzen
Hoeleden	Kortenaken
Hoepertingen	Borgloon
Hoeselt	Hoeselt
Hoevenen	Stabroek
Hofstade	Aalst
Hofstade	Zemst
Hollebeke	Ieper
Holsbeek	Holsbeek
Hombeek	Mechelen
Hooglede	Hooglede
Hoogstade	Alveringem
Hoogstraten	Hoogstraten
Horpmaal	Heers
Houtave	Zuienkerke
Houtem	Veurne
Houthalen	Houthalen-Helchteren
Houthulst	Houthulst
Houtvenne	Hulshout
Houwaart	Tielt-Winge
Hove	Hove
Huise	Zingem
Huizingen	Beersel
Huldenberg	Huldenberg
Hulshout	Hulshout
Hulste	Harelbeke
Humbeek	Grimbergen
Hundelgem	Zwalm
Ichtegem	Ichtegem
Iddergem	Denderleeuw
Idegem	Geraardsbergen
Ieper	Ieper
Impe	Lede
Ingelmunster	Ingelmunster
Ingooigem	Anzegem
Itegem	Heist-op-den-Berg
Itterbeek	Dilbeek
Izegem	Izegem
Izenberge	Alveringem
Jabbeke	Jabbeke
Jesseren	Borgloon
Jeuk	Gingelom
Kaaskerke	Diksmuide
Kachtem	Izegem
Kaggevinne	Diest
Kalken	Laarne
Kallo	Beveren
Kalmthout	Kalmthout
Kampenhout	Kampenhout
Kanegem	Tielt
Kanne	Riemst
Kapelle-op-den-Bos	Kapelle-op-den-Bos
Kapellen	Glabbeek
Kapellen	Kapellen
Kaprijke	Kaprijke
Kaster	Anzegem
Kasterlee	Kasterlee
Kaulille	Bocholt
Keerbergen	Keerbergen
Keiem	Diksmuide
Kemmel	Heuvelland
Kemzeke	Stekene
Kerkhove	Avelgem
Kerkom	Boutersem
Kerkom-bij-Sint-Truiden	Sint-Truiden
Kerksken	Haaltert
Kermt	Hasselt
Kerniel	Borgloon
Kersbeek-Miskom	Kortenaken
Kessel	Nijlen
Kessel-Lo	Leuven
Kessenich	Kinrooi
Kester	Gooik
Kieldrecht	Beveren
Kinrooi	Kinrooi
Klein-Gelmen	Heers
Kleine-Brogel	Peer
Kleine-Spouwen	Bilzen
Klemskerke	De Haan
Klerken	Houthulst
Kluizen	Evergem
Knesselare	Knesselare
Knokke	Knokke-Heist
Kobbegem	Asse
Koekelare	Koekelare
Koersel	Beringen
Koksijde	Koksijde
Koningshooikt	Lier
Koninksem	Tongeren
Kontich	Kontich
Kooigem	Kortrijk
Koolkerke	Brugge
Koolskamp	Ardooie
Korbeek-Dijle	Bertem
Korbeek-Lo	Bierbeek
Kortemark	Kortemark
Kortenaken	Kortenaken
Kortenberg	Kortenberg
Kortessem	Kortessem
Kortijs	Gingelom
Kortrijk	Kortrijk
Kortrijk-Dutsel	Holsbeek
Kozen	Nieuwerkerken
Kraainem	Kraainem
Krombeke	Poperinge
Kruibeke	Kruibeke
Kruishoutem	Kruishoutem
Kumtich	Tienen
Kuringen	Hasselt
Kuttekoven	Borgloon
Kuurne	Kuurne
Kwaadmechelen	Ham
Kwaremont	Kluisbergen
Laar	Landen
Laar	Zemst
Laarne	Laarne
Lampernisse	Diksmuide
Lanaken	Lanaken
Landegem	Nevele
Landen	Landen
Landskouter	Oosterzele
Langdorp	Aarschot
Langemark	Langemark-Poelkapelle
Lanklaar	Dilsen-Stokkem
Lapscheure	Damme
Lauw	Tongeren
Lauwe	Menen
Lebbeke	Lebbeke
Lede	Lede
Ledeberg	Gent
Ledegem	Ledegem
Leefdaal	Bertem
Leerbeek	Gooik
Leest	Mechelen
Leeuwergem	Zottegem
Leffinge	Middelkerke
Leisele	Alveringem
Leke	Diksmuide
Lembeek	Halle
Lembeke	Kaprijke
Lemberge	Merelbeke
Lendelede	Lendelede
Leopoldsburg	Leopoldsburg
Letterhoutem	Sint-Lievens-Houtem
Leupegem	Oudenaarde
Leut	Maasmechelen
Leuven	Leuven
Lichtaart	Kasterlee
Lichtervelde	Lichtervelde
Liedekerke	Liedekerke
Lieferinge	Ninove
Lier	Lier
Liezele	Puurs
Lille	Lille
Linden	Lubbeek
Linkebeek	Linkebeek
Linkhout	Lummen
Lint	Lint
Lippelo	Sint-Amands
Lissewege	Brugge
Lo	Lo-Reninge
Lochristi	Lochristi
Loenhout	Wuustwezel
Loker	Heuvelland
Lokeren	Lokeren
Loksbergen	Halen
Lombardsijde	Middelkerke
Lommel	Lommel
Londerzeel	Londerzeel
Loonbeek	Huldenberg
Loppem	Zedelgem
Lot	Beersel
Lotenhulle	Aalter
Lovendegem	Lovendegem
Lovenjoel	Bierbeek
Lubbeek	Lubbeek
Lummen	Lummen
Maarke-Kerkem	Maarkedal
Maaseik	Maaseik
Machelen	Machelen
Machelen	Zulte
Mal	Tongeren
Maldegem	Maldegem
Malderen	Londerzeel
Mannekensvere	Middelkerke
Mariakerke	Gent
Mariekerke	Bornem
Marke	Kortrijk
Markegem	Dentergem
Martenslinde	Bilzen
Massemen	Wetteren
Massenhoven	Zandhoven
Mater	Oudenaarde
Mazenzele	Opwijk
Mechelen	Mechelen
Mechelen-Bovelingen	Heers
Mechelen-aan-de-Maas	Maasmechelen
Meensel-Kiezegem	Tielt-Winge
Meer	Hoogstraten
Meerbeek	Kortenberg
Meerbeke	Ninove
Meerdonk	Sint-Gillis-Waas
Meerhout	Meerhout
Meerle	Hoogstraten
Meeswijk	Maasmechelen
Meetkerke	Zuienkerke
Meeuwen	Meeuwen-Gruitrode
Meigem	Deinze
Meilegem	Zwalm
Meise	Meise
Melden	Oudenaarde
Meldert	Aalst
Meldert	Hoegaarden
Meldert	Lummen
Melkwezer	Linter
Melle	Melle
Melsbroek	Steenokkerzeel
Melsele	Beveren
Melsen	Merelbeke
Membruggen	Riemst
Mendonk	Gent
Menen	Menen
Merchtem	Merchtem
Mere	Erpe-Mere
Merelbeke	Merelbeke
Merendree	Nevele
Merkem	Houthulst
Merksem	Antwerpen
Merksplas	Merksplas
Mesen	Mesen
Mespelare	Dendermonde
Messelbroek	Scherpenheuvel-Zichem
Mettekoven	Heers
Meulebeke	Meulebeke
Michelbeke	Brakel
Middelburg	Maldegem
Middelkerke	Middelkerke
Mielen-boven-Aalst	Gingelom
Millen	Riemst
Minderhout	Hoogstraten
Moelingen	Voeren
Moen	Zwevegem
Moerbeke	Geraardsbergen
Moerbeke	Moerbeke
Moere	Gistel
Moerkerke	Damme
Moerzeke	Hamme
Mol	Mol
Molenbeek-Wersbeek	Bekkevoort
Molenbeersel	Kinrooi
Molenstede	Diest
Mollem	Asse
Montenaken	Gingelom
Moorsel	Aalst
Moorsele	Wevelgem
Moorslede	Moorslede
Moortsele	Oosterzele
Mopertingen	Bilzen
Moregem	Wortegem-Petegem
Morkhoven	Herentals
Mortsel	Mortsel
Muizen	Gingelom
Muizen	Mechelen
Mullem	Oudenaarde
Munkzwalm	Zwalm
Munsterbilzen	Bilzen
Munte	Merelbeke
Nazareth	Nazareth
Nederboelare	Geraardsbergen
Nederbrakel	Brakel
Nederename	Oudenaarde
Nederhasselt	Ninove
Nederokkerzeel	Kampenhout
Nederzwalm-Hermelgem	Zwalm
Neerglabbeek	Meeuwen-Gruitrode
Neerharen	Lanaken
Neerhespen	Linter
Neerijse	Huldenberg
Neerlanden	Landen
Neerlinter	Linter
Neeroeteren	Maaseik
Neerpelt	Neerpelt
Neerrepen	Tongeren
Neervelp	Boutersem
Neerwinden	Landen
Neigem	Ninove
Nerem	Tongeren
Nevele	Nevele
Niel	Niel
Niel-bij-As	As
Niel-bij-Sint-Truiden	Gingelom
Nieuwenhove	Geraardsbergen
Nieuwenrode	Kapelle-op-den-Bos
Nieuwerkerken	Aalst
Nieuwerkerken	Nieuwerkerken
Nieuwkapelle	Diksmuide
Nieuwkerke	Heuvelland
Nieuwkerken-Waas	Sint-Niklaas
Nieuwmunster	Zuienkerke
Nieuwpoort	Nieuwpoort
Nieuwrode	Holsbeek
Nijlen	Nijlen
Ninove	Ninove
Nokere	Kruishoutem
Noorderwijk	Herentals
Noordschote	Lo-Reninge
Nossegem	Zaventem
Nukerke	Maarkedal
Oedelem	Beernem
Oekene	Roeselare
Oelegem	Ranst
Oeren	Alveringem
Oeselgem	Dentergem
Oetingen	Gooik
Oevel	Westerlo
Okegem	Ninove
Olen	Olen
Olmen	Balen
Olsene	Zulte
Onkerzele	Geraardsbergen
Onze-Lieve-Vrouw-Lombeek	Roosdaal
Onze-Lieve-Vrouw-Waver	Sint-Katelijne-Waver
Ooigem	Wielsbeke
Ooike	Wortegem-Petegem
Oombergen	Zottegem
Oorbeek	Tienen
Oordegem	Lede
Oostakker	Gent
Oostduinkerke	Koksijde
Oosteeklo	Assenede
Oostende	Oostende
Oosterzele	Oosterzele
Oostham	Ham
Oostkamp	Oostkamp
Oostkerke	Damme
Oostkerke	Diksmuide
Oostmalle	Malle
Oostnieuwkerke	Staden
Oostrozebeke	Oostrozebeke
Oostvleteren	Vleteren
Oostwinkel	Zomergem
Opbrakel	Brakel
Opdorp	Buggenhout
Opglabbeek	Opglabbeek
Opgrimbie	Maasmechelen
Ophasselt	Geraardsbergen
Opheers	Heers
Ophoven	Kinrooi
Opitter	Bree
Oplinter	Tienen
Opoeteren	Maaseik
Oppuurs	Sint-Amands
Opvelp	Bierbeek
Opwijk	Opwijk
Ordingen	Sint-Truiden
Orsmaal-Gussenhoven	Linter
Otegem	Zwevegem
Ottenburg	Huldenberg
Ottergem	Erpe-Mere
Oud-Heverlee	Oud-Heverlee
Oud-Turnhout	Oud-Turnhout
Oudegem	Dendermonde
Oudekapelle	Diksmuide
Oudenaarde	Oudenaarde
Oudenaken	Sint-Pieters-Leeuw
Oudenberg	Oudenburg
Outer	Ninove
Outgaarden	Hoegaarden
Outrijve	Avelgem
Ouwegem	Zingem
Overboelare	Geraardsbergen
Overhespen	Linter
Overijse	Overijse
Overmere	Berlare
Overpelt	Overpelt
Overrepen	Tongeren
Overwinden	Landen
Paal	Beringen
Pamel	Roosdaal
Parike	Brakel
Passendale	Zonnebeke
Paulatem	Zwalm
Peer	Peer
Pellenberg	Lubbeek
Pepingen	Pepingen
Perk	Steenokkerzeel
Pervijze	Diksmuide
Petegem-aan-de-Leie	Deinze
Petegem-aan-de-Schelde	Wortegem-Petegem
Peutie	Vilvoorde
Piringen	Tongeren
Pittem	Pittem
Poederlee	Lille
Poeke	Aalter
Poelkapelle	Langemark-Poelkapelle
Poesele	Nevele
Pollare	Ninove
Pollinkhove	Lo-Reninge
Poperinge	Poperinge
Poppel	Ravels
Proven	Poperinge
Pulderbos	Zandhoven
Pulle	Zandhoven
Putte	Putte
Puurs	Puurs
Ramsdonk	Kapelle-op-den-Bos
Ramsel	Herselt
Ramskapelle	Knokke-Heist
Ramskapelle	Nieuwpoort
Ransberg	Kortenaken
Ranst	Ranst
Ravels	Ravels
Reet	Rumst
Rekem	Lanaken
Rekkem	Menen
Relegem	Asse
Remersdaal	Voeren
Reninge	Lo-Reninge
Reningelst	Poperinge
Reppel	Bocholt
Ressegem	Herzele
Retie	Retie
Riemst	Riemst
Rijkel	Borgloon
Rijkevorsel	Rijkevorsel
Rijkhoven	Bilzen
Rijmenam	Bonheiden
Riksingen	Tongeren
Rillaar	Aarschot
Roborst	Zwalm
Roesbrugge-Haringe	Poperinge
Roeselare	Roeselare
Roksem	Oudenburg
Rollegem	Kortrijk
Rollegem-Kapelle	Ledegem
Romershoven	Hoeselt
Ronse	Ronse
Ronsele	Zomergem
Roosbeek	Boutersem
Rosmeer	Bilzen
Rotem	Dilsen-Stokkem
Rotselaar	Rotselaar
Rozebeke	Zwalm
Ruddervoorde	Oostkamp
Ruien	Kluisbergen
Ruisbroek	Puurs
Ruisbroek	Sint-Pieters-Leeuw
Ruiselede	Ruiselede
Rukkelingen-Loon	Heers
Rumbeke	Roeselare
Rummen	Geetbets
Rumsdorp	Landen
Rumst	Rumst
Runkelen	Sint-Truiden
Rupelmonde	Kruibeke
Rutten	Tongeren
Schaffen	Diest
Schalkhoven	Hoeselt
Schelderode	Merelbeke
Scheldewindeke	Oosterzele
Schelle	Schelle
Schellebelle	Wichelen
Schendelbeke	Geraardsbergen
Schepdaal	Dilbeek
Scherpenheuvel	Scherpenheuvel-Zichem
Schilde	Schilde
Schoonaarde	Dendermonde
Schore	Middelkerke
Schorisse	Maarkedal
Schoten	Schoten
Schriek	Heist-op-den-Berg
Schuiferskapelle	Tielt
Schulen	Herk-de-Stad
Semmerzake	Gavere
Serskamp	Wichelen
Sijsele	Damme
Sinaai	Sint-Niklaas
Sint-Agatha-Rode	Huldenberg
Sint-Amands	Sint-Amands
Sint-Amandsberg	Gent
Sint-Andries	Brugge
Sint-Antelinks	Herzele
Sint-Baafs-Vijve	Wielsbeke
Sint-Blasius-Boekel	Zwalm
Sint-Denijs	Zwevegem
Sint-Denijs-Boekel	Zwalm
Sint-Denijs-Westrem	Gent
Sint-Eloois-Vijve	Waregem
Sint-Eloois-Winkel	Ledegem
Sint-Genesius-Rode	Sint-Genesius-Rode
Sint-Gillis-Waas	Sint-Gillis-Waas
Sint-Gillis-bij-Dendermonde	Dendermonde
Sint-Goriks-Oudenhove	Zottegem
Sint-Huibrechts-Hern	Hoeselt
Sint-Huibrechts-Lille	Neerpelt
Sint-Jacobskapelle	Diksmuide
Sint-Jan	Ieper
Sint-Jan-in-Eremo	Sint-Laureins
Sint-Job-in-'t-Goor	Brecht
Sint-Joris	Beernem
Sint-Joris	Nieuwpoort
Sint-Joris-Weert	Oud-Heverlee
Sint-Joris-Winge	Tielt-Winge
Sint-Katelijne-Waver	Sint-Katelijne-Waver
Sint-Katherina-Lombeek	Ternat
Sint-Kornelis-Horebeke	Horebeke
Sint-Kruis	Brugge
Sint-Kruis-Winkel	Gent
Sint-Kwintens-Lennik	Lennik
Sint-Lambrechts-Herk	Hasselt
Sint-Laureins	Sint-Laureins
Sint-Laureins-Berchem	Sint-Pieters-Leeuw
Sint-Lenaarts	Brecht
Sint-Lievens-Esse	Herzele
Sint-Lievens-Houtem	Sint-Lievens-Houtem
Sint-Margriete	Sint-Laureins
Sint-Margriete-Houtem	Tienen
Sint-Maria-Horebeke	Horebeke
Sint-Maria-Latem	Zwalm
Sint-Maria-Lierde	Lierde
Sint-Maria-Oudenhove	Zottegem
Sint-Martens-Bodegem	Dilbeek
Sint-Martens-Latem	Sint-Martens-Latem
Sint-Martens-Leerne	Deinze
Sint-Martens-Lennik	Lennik
Sint-Martens-Lierde	Lierde
Sint-Martens-Voeren	Voeren
Sint-Michiels	Brugge
Sint-Niklaas	Sint-Niklaas
Sint-Pauwels	Sint-Gillis-Waas
Sint-Pieters-Kapelle	Herne
Sint-Pieters-Kapelle	Middelkerke
Sint-Pieters-Leeuw	Sint-Pieters-Leeuw
Sint-Pieters-Rode	Holsbeek
Sint-Pieters-Voeren	Voeren
Sint-Rijkers	Alveringem
Sint-Stevens-Woluwe	Zaventem
Sint-Truiden	Sint-Truiden
Sint-Ulriks-Kapelle	Dilbeek
Sleidinge	Evergem
Slijpe	Middelkerke
Sluizen	Tongeren
Smeerebbe-Vloerzegem	Geraardsbergen
Smetlede	Lede
Snaaskerke	Gistel
Snellegem	Jabbeke
Spalbeek	Hasselt
Spiere	Spiere-Helkijn
Stabroek	Stabroek
Staden	Staden
Stalhille	Jabbeke
Stavele	Alveringem
Steendorp	Temse
Steenhuffel	Londerzeel
Steenhuize-Wijnhuize	Herzele
Steenkerke	Veurne
Steenokkerzeel	Steenokkerzeel
Stekene	Stekene
Stene	Oostende
Sterrebeek	Zaventem
Stevoort	Hasselt
Stokkem	Dilsen-Stokkem
Stokrooie	Hasselt
Strijpen	Zottegem
Strijtem	Roosdaal
Strombeek-Bever	Grimbergen
Stuivekenskerke	Diksmuide
Temse	Temse
Teralfene	Affligem
Terhagen	Rumst
Ternat	Ternat
Tervuren	Tervuren
Tessenderlo	Tessenderlo
Testelt	Scherpenheuvel-Zichem
Teuven	Voeren
Tiegem	Anzegem
Tielen	Kasterlee
Tielrode	Temse
Tielt	Tielt
Tielt	Tielt-Winge
Tienen	Tienen
Tildonk	Haacht
Tisselt	Willebroek
Tollembeek	Galmaarden
Tongeren	Tongeren
Tongerlo	Bree
Tongerlo	Westerlo
Torhout	Torhout
Tremelo	Tremelo
Turnhout	Turnhout
Uikhoven	Maasmechelen
Uitbergen	Berlare
Uitkerke	Blankenberge
Ulbeek	Wellen
Ursel	Knesselare
Vaalbeek	Oud-Heverlee
Val-Meer	Riemst
Varendonk	Laakdal
Varsenare	Jabbeke
Vechmaal	Heers
Veerle	Laakdal
Veldegem	Zedelgem
Veldwezelt	Lanaken
Velm	Sint-Truiden
Veltem-Beisem	Herent
Velzeke-Ruddershove	Zottegem
Verrebroek	Beveren
Vertrijk	Boutersem
Veulen	Heers
Veurne	Veurne
Viane	Geraardsbergen
Vichte	Anzegem
Viersel	Zandhoven
Vilvoorde	Vilvoorde
Vinderhoute	Lovendegem
Vinkem	Veurne
Vinkt	Deinze
Vladslo	Diksmuide
Vlamertinge	Ieper
Vlekkem	Erpe-Mere
Vlezenbeek	Sint-Pieters-Leeuw
Vliermaal	Kortessem
Vliermaalroot	Kortessem
Vlierzele	Sint-Lievens-Houtem
Vlijtingen	Riemst
Vlimmeren	Beerse
Vlissegem	De Haan
Volkegem	Oudenaarde
Vollezele	Galmaarden
Voorde	Ninove
Voormezele	Ieper
Voort	Borgloon
Vorselaar	Vorselaar
Vorsen	Gingelom
Vorst	Laakdal
Vosselaar	Vosselaar
Vosselare	Nevele
Vossem	Tervuren
Vrasene	Beveren
Vremde	Boechout
Vreren	Tongeren
Vroenhoven	Riemst
Vucht	Maasmechelen
Vurste	Gavere
Waanrode	Kortenaken
Waarbeke	Geraardsbergen
Waardamme	Oostkamp
Waarloos	Kontich
Waarmaarde	Avelgem
Waarschoot	Waarschoot
Waasmont	Landen
Waasmunster	Waasmunster
Wachtebeke	Wachtebeke
Wakken	Dentergem
Walem	Mechelen
Walsbets	Landen
Walshoutem	Landen
Waltwilder	Bilzen
Wambeek	Ternat
Wange	Landen
Wannegem-Lede	Kruishoutem
Wanzele	Lede
Waterland-Oudeman	Sint-Laureins
Watervliet	Sint-Laureins
Watou	Poperinge
Webbekom	Diest
Wechelderzande	Lille
Weelde	Ravels
Weerde	Zemst
Weert	Bornem
Welden	Oudenaarde
Welle	Denderleeuw
Wellen	Wellen
Wemmel	Wemmel
Wenduine	De Haan
Werchter	Rotselaar
Werken	Kortemark
Werm	Hoeselt
Wervik	Wervik
Wespelaar	Haacht
Westende	Middelkerke
Westerlo	Westerlo
Westkapelle	Knokke-Heist
Westkerke	Oudenburg
Westmalle	Malle
Westmeerbeek	Hulshout
Westouter	Heuvelland
Westrem	Wetteren
Westrozebeke	Staden
Westvleteren	Vleteren
Wetteren	Wetteren
Wevelgem	Wevelgem
Wezemaal	Rotselaar
Wezembeek-Oppem	Wezembeek-Oppem
Wezeren	Landen
Wichelen	Wichelen
Widooie	Tongeren
Wiekevorst	Heist-op-den-Berg
Wielsbeke	Wielsbeke
Wieze	Lebbeke
Wijchmaal	Peer
Wijer	Nieuwerkerken
Wijgmaal	Leuven
Wijnegem	Wijnegem
Wijshagen	Meeuwen-Gruitrode
Wijtschate	Heuvelland
Wilderen	Sint-Truiden
Willebringen	Boutersem
Willebroek	Willebroek
Wilrijk	Antwerpen
Wilsele	Leuven
Wilskerke	Middelkerke
Wimmertingen	Hasselt
Wingene	Wingene
Winksele	Herent
Wintershoven	Kortessem
Woesten	Vleteren
Wolvertem	Meise
Wommelgem	Wommelgem
Wommersom	Linter
Wondelgem	Gent
Wontergem	Deinze
Wortegem	Wortegem-Petegem
Wortel	Hoogstraten
Woubrechtegem	Herzele
Woumen	Diksmuide
Wulpen	Koksijde
Wulvergem	Heuvelland
Wulveringem	Veurne
Wuustwezel	Wuustwezel
Zaffelare	Lochristi
Zandbergen	Geraardsbergen
Zande	Koekelare
Zandhoven	Zandhoven
Zandvoorde	Oostende
Zandvoorde	Zonnebeke
Zarlardinge	Geraardsbergen
Zaventem	Zaventem
Zedelgem	Zedelgem
Zegelsem	Brakel
Zele	Zele
Zelem	Halen
Zellik	Asse
Zelzate	Zelzate
Zemst	Zemst
Zepperen	Sint-Truiden
Zerkegem	Jabbeke
Zevekote	Gistel
Zeveneken	Lochristi
Zeveren	Deinze
Zevergem	De Pinte
Zichem	Scherpenheuvel-Zichem
Zichen-Zussen-Bolder	Riemst
Zillebeke	Ieper
Zingem	Zingem
Zoerle-Parwijs	Westerlo
Zoersel	Zoersel
Zolder	Heusden-Zolder
Zomergem	Zomergem
Zonhoven	Zonhoven
Zonnebeke	Zonnebeke
Zonnegem	Sint-Lievens-Houtem
Zottegem	Zottegem
Zoutenaaie	Veurne
Zoutleeuw	Zoutleeuw
Zuidschote	Ieper
Zuienkerke	Zuienkerke
Zulte	Zulte
Zulzeke	Kluisbergen
Zutendaal	Zutendaal
Zwalm	Zwalm
Zwevegem	Zwevegem
Zwevezele	Wingene
Zwijnaarde	Gent
Zwijndrecht	Zwijndrecht